{
    "charsMap": {"#": "green", "S": "grey", "W": "blue"},
    "map": [["#","#","#","#","#","#","#","#"],
            ["W","#","#","#","#","#","#","W"],
            ["#","#","#","#","#","#","#","W"],
            ["#","#","#","S","S","#","#","W"],
            ["#","#","#","S","S","#","#","#"],
            ["#","#","#","#","#","#","#","#"],
            ["#","#","#","#","#","#","#","#"],
            ["#","#","#","#","#","#","#","#"],
            ["#","#","#","#","#","#","#","#"]]
}
